##################################################################################
#         #       ###       ######################################################
#         #                 ######################################################
#         #       ###       ######################################################
#         #       ###       ######################################################
##### ##### ########## ###########################################################
#     ##### #          #        ##################################################
# ######### #          #        ##################################################
#       ### #          #        ##################################################
#       ### # ########## #########################################################
#           #            #########################################################
##################################################################################
##################################################################################
##################################################################################
##################################################################################
##################################################################################
##################################################################################
##################################################################################
############################################################################     #
############################################################################     #
############################################################################     #
##################################################################################