##################################################################################
#                                                                                #
#                                                                                #
#                                                                                #
#                                                                                #
#                                                                                #
#                                                                                #
#                                ####                                            #
#                                #  #                                            #
#                                ####                                            #
#                                                                                #
#                                                                                #
#                                                                                #
#                                                                                #
#                                                                                #
#                                                                                #
#                                                                                #
#                                                                           ######
#    ########################################################################    #
#                                                                                #
#                                                                           #    #
##################################################################################