##################################################################################
#         #       ###       ######          #####          #########          ####
#         #                                 #####                             ####
#         #       ###       ## ###                         #########          ####
#         #       ###       ## ####### #############   #################### ######
#####-##### ########## ####### #####           #####                             #
#     ##### #          #        ####           ##### ## #############            #
# ######### #          #        ####                 ## ##################### ####
#       ### #          #        ####           ######## #####                    #
#       ### # ########## ###########           ###         ##                    #
#           #            #########################         ##                    #
###########################          #############         ##                    #
#           ###############                    ###         ##                    #
#                                    ######### ########################## ########
#           ##########################                ################### ########
#### ##################             ##                                    ########
#### ###########                    ##                ###################-########
##          #### ######             #####################                 ########
##           ### ########### ###########         #              ##        ##     #
##               ###########                     # ######       ##               #
##           ###########################           ###############        ##     #
##################################################################################